R 2500 2500
SO ./get_next_line.c
WE ./routing1.c
EA ./get_next_line.c
NO ./FILE WITH SPACES 
S  ./get_next_line.h
F  10,0,10
C  12,12,30

111111111111111111111111111111111111111111111111111111111111111111111111111111111111111111111111111111111111111111
1000001111111111                                                                                                 1
1000000000000001                                                                                                  1
1000000000000001                                                                                                 1
1000000001110001    1                                                                                             1
1000000001110001   101              1111111    1111111   1111111   1111111    11    11                           1
1000011111111111    1               1     1    1     1   1     1   1     1    11    11                            1
100001                              1111111    1111111   1111111   1111111    11111111                           1
100001                              1     1    1         1     1   1     1    11    11                            1
100001111111111111111111111111      1     1    1         1     1   1     1    11    11                           1
100000000000000000000000000001                                                                                    1
10000S000000000000000000000001                                                                                   1
100000000000000000000000000001                                                                                    1
100001111111111111111111111111                                                                                   1
100001                                                                                                            1
111111111111111111111111111111111111111111111111111111111111111111111111111111111111111111111111111111111111111111 
 
1111
1001
1111
